1111111111111111111111111111
1400004000004114000004000041
1011110111110110111110111101
1011110111110110111110111101
1011110111110110111110111101
1400004004004004004004000041
1011110110111111110110111101
1011110110111111110110111101
1400004114004114004114000041
1111110111110110111110111111
1111110111110110111110111111
1111110114004444004110111111
1111110110111221110110111111
1111110110152222610110111111
0000004004122222214004000000
1111110110122222210110111111
1111110110111111110110111111
1111110114000030004110111111
1111110110111111110110111111
1111110110111111110110111111
1400004004004114004004000041
1011110111110110111110111101
1011110111110110111110111101
1404114004004004004004114041
1110110110111111110110110111
1110110110111111110110110111
1404004114004114004114004041
1011111111110110111111111101
1011111111110110111111111101
1400000000004004000000000041
1111111111111111111111111111
